- vHa KH pepc .
Udikpbiw ) KeNMWUM - bing KbI pepc .
MynbkveT arbamacbIHeH KesIbreH UCHMJIEPHHHd KENIMLUJIEPHEH TIOP eHIOBU - HaKu pepc .
Kenuw sanrbamanapbiHbIHb HM IACbI - vHm Ku pepc .
Hytyk HHKMWadb !
AepcH .
HytyKd ycnionnepu ( Pecmun ycnion ) - HmKuH gepc .
Ucumnepfe OxwaB - KHUMbTIOB A ITbamManapbl - 10oHm KH Bepc .
UcumnepHiHd AnbisyBbI BE ONAPHbIHb MM IACDI - roHm KH Aepc .
CuHTaKTHK yCyHeH MCHM AnyB - uHm KH pepc .
Hytykb HHKMWadppl Aepcu .
Hytyk ycnionnepu ( Unbmun ycnion ) - Hg « bI Aepc .
Coicbat - HmKHW mepc .
Acbin Be HuCOMM cbicbaTnap - uHg pKH mepc .
CoicbaT ZepemxKenepu - biH xKbI Bepc .
CoicbaTnapHbIHb TeHbeLUTHpIOB AepemKecu - biHA KbI AeEpc .
CricbaTnapHbIHb yCTIOHNHK BepemKecu - uHAKM Aepc .
A3nawtbipma cbidbatTnap - HaxKH pepc .
Hytykb HHKMWadbi Aepcu .
TapudnenugKn vHWa - roHm KM Bepc .
KbyBeTneHaANpMe CbicbaTnap - toHm KH pepc .
CricbaTnapHbiHd sAnbiNyBbI - wHa » xKM Aepc .
CuHTaKTHK yCysbIHeH cbicpaT ANyB - Ha kbI Aepc .
HytTykb HHKMWadbbI AepcH .
VcaH KbbIAcpeTHHHHD Tapudu - Ha xKH mepc .
Coicbat ( TeKpapnas gepcn ) - nvHAxKHM Aepc .
Cail - biIHm KbI Bepc .
CaibinapHbiIHb , MaHanapbiHa KOpe , YeLUKTNeEpH - vHaxKKM Aepc .
Kecup caibinap - uH KKM Aepc .
Coipa canbinappbl - HaKu gepc .
Man campinapp !
- roHm KH Bepc .
TaxmuHun canbinap - roHm KH pepc .
CalbinapHbIHb TH3HNIOB D Ke3STTeH YeLUMTNeEpU
